freight -- груз, грузовой
French -- французский
frequent -- частый
frequently -- часто
fresh -- свежий, бодрый
Friday -- пятница
fried -- жареный
friend -- друг
friendly -- дружеский, дружелюбный
friends -- друзья (от friend)
friendship -- дружба -ship
fright -- испуг
frighten -- пугать
frightful -- страшный, ужасный
fringe -- бахрома, край
fritter -- пончик, крошить
fro -- обратно !NEW!
frog -- лягушка
frolic -- веселиться, проказничать
from -- от, из
front -- перед, передняя сторона, фронт
frontier -- граница *r-
frost -- мороз
frosty -- морозный
frown -- нахмуриться, недовольное выражение лица
fruit -- фрукты
fruitless -- бесплодный
frustration -- расстройство
fry -- (за)жарить
fudge -- глупость, чушь
fuel -- топливо, горючее
fugitive -- беглый, мимолетный, беглец
fulfil -- выполнить
full -- полный
fully -- вполне, полностью f-
fun -- шутка, веселье
function -- функция, торжество
functions -- Функции (TR!)
fund -- фонд
funeral -- похороны, похоронный
funnel -- воронка, труба (паровоза, парохода)
funny -- смешной, забавный
fur -- мех, шкура
furious -- взбешенный, бешеный, неистовый
furnace -- печь, топка, горн
furnish -- снабжать, меблировать, обставлять
furnished -- снаряженный, оборудованный, экипированный !NEW!
furniture -- мебель
furrow -- борозда, колея
furry -- пушистый (не downy)
furs -- меха (от fur)
further -- дальнейший, дополнительный (*u*****)
furthermore -- кроме того
fury -- неистовство
fuse -- плавить(ся), сплавлять(ся), перегорать
fuss -- суета; суетиться, беспокоиться, хлопотать f- (не stir)
futile -- бесполезный, тщетный, пустой (о человеке)
future -- будущее
gag -- затычка, кляп
gaily -- весело, оживленно (g -- первая буква)
gain -- прибыль
gained -- Полученный (TR!)
galactic -- Галактический (TR!)
galaxy -- Галактика (TR!)
gale -- шторм
gallant -- доблестный, отважный, смелый, храбрый (g-)
gallery -- галерея
game -- игра
games -- игры (от game)
gang -- шайка, банда
gangster -- бандит, гангстер
gap -- брешь
garage -- гараж
garbage -- мусор
garden -- сад
gardener -- садовник
gardening -- садоводство -ing
gargling -- полоскающий (от gargle)
garlic -- чеснок
garment -- одежда, одеяние g-
garments -- Предметы одежды (TR!)
garret -- мансарда, чердак
garrison -- гарнизон, ставить гарнизон
gas -- газ
gasoline -- газолин, бензин (амер.)
gasp -- задыхаться (не pant)
gasped -- Задыхался (не от слова pant) (TR!)
gate -- ворота, проход
gates -- стойки (от gate)
gather -- собираться
gathering -- собрание, сборище -ing
gaunt -- Изможденный (TR!)
gave -- дал (от give)
gay -- веселый g-
gaze -- пристально глядеть, пристальный взгляд g-
gear -- механизм
gem -- драгоценный камень
gene -- ген
general -- общий
generally -- вообще, обычно
generate -- порождать
generation -- поколение
generations -- Поколения (TR!)
generator -- Генератор (TR!)
generosity -- благородство, щедрость
generous -- великодушный
genius -- гений
gentle -- нежный, ласковый g-
gentleman -- господин, джентльмен
gentlemen -- господа (от gentleman)
gently -- мягко, кротко g-
genuine -- подлинный
genus -- Род (TR!)
geoff -- Джеф (TR!)
geoffrey -- Джеффри (TR!)
geographical -- географический
geological -- Геологический (TR!)
geology -- геология
geometry -- геометрия
georgiana -- Георгиана (TR!)
germ -- зародыш (биолог.), микроб
german -- Немец (TR!)
germany -- Германия (TR!)
gesture -- жест
get -- получать, доставать, достигать, добраться
gets -- действует (от get)
getting -- передвижение
ghost -- привидение, дух
ghosts -- Призраки (TR!)
giant -- гигант, гигантский
gift -- подарок
gifted -- одаренный
gigantic -- гигантский
ginny -- Гинни (TR!)
Gipsy -- цыганский, цыган(ка)
girl -- девочка, девушка
give -- давать
given -- данный (от give)
glacier -- ледник, глетчер
glad -- рад
gladly -- С удовольствием (TR!)
glance -- взглянуть, мелькнуть
glanced -- Поглядел (TR!)
glancing -- Глядящий -ing (TR!)
gland -- железа
glands -- Гланды (TR!)
glare -- сверкать
glass -- стакан, бокал
glasses -- очки
gleam -- проблеск, светиться
gleamed -- Мерцал (не blinked) (TR!)
gleaming -- Блеск -ing (TR!)
glide -- скользить, планировать (авиа)
glimpse -- мелькание, мельком взглянуть !NEW!
glitter -- блеск, блестеть
glittering -- Сверкание -ing (TR!)
globe -- земной шар, глобус
gloom -- мрак, уныние
gloomily -- Уныло (не ruefully) (TR!)
gloomy -- мрачный (не dreary)
gloria -- Глория (TR!)
glorious -- великолепный, славный
glory -- слава
glossy -- глянцевитый, блестящий (о волосах)
glove -- перчатка
gloves -- перчатки (от glove)
glow -- сильный жар, накаляться (не heat)
glowing -- Пылающий *l-ing (TR!)
glue -- клей; клеить, приклеивать
gnaw -- грызть, глодать
go -- идти
goal -- цель, гол
goat -- козел, коза
goats -- Козлы (TR!)
god -- бог, божество
goes -- идет (от go)
going -- идущий (от go)
golan -- Голанский (TR!)
gold -- золото, золотой
golden -- золотой, золотистый
good -- хороший, добрый, добро, польза
goodbye -- прощание
goodness -- доброта; великодушие; любезность !NEW!
goods -- товары
goodwill -- добрая воля
goon -- придурок !NEW!
goose -- гусь
gooseberry -- крыжовник
gos -- Идет (TR!)
gosh -- боже !NEW!
gossip -- сплетня
got -- получил, полученный (от get)
govern -- управлять g-
government -- правительство
governor -- губернатор
gown -- платье
grab -- внезапно схватывать
grabbed -- Захваченный (TR!)
grace -- грация, изящество
graceful -- грациозный
gracious -- милосердный gr-
grade -- сортировать, степень
gradual -- постепенно
gradually -- постепенно
graduated -- окончил, окончивший учебное заведение (от graduate)
grain -- зерно
grains -- Зерно *r-s (TR!)
gram -- грамм
grammar -- грамматика
grand -- величественный
grandchildren -- внуки
grandeur -- величие, великолепие, грандиозность g-
grandfather -- дедушка
grandmother -- бабушка
grandparents -- дедушка и бабушка
grandson -- внук
granite -- гранит
grant -- дарить, дар
granted -- дарованный !NEW!
grapes -- виноград
graphic -- графический, наглядный, образный
grasp -- понять, схватить
grass -- трава
grasshopper -- кузнечик
grate -- каминная решетка
grateful -- благодарный g-
grater -- терка
gratified -- Удовлетворенный (*r-) (TR!)
gratitude -- благодарность
grave -- могила, серьезный, важный
gravel -- гравий
gravely -- серьезно, здраво, рассудительно (*r-) !NEW!
graveyard -- Кладбище (TR!)
gravity -- серьезность
gravy -- подливка, соус
gray -- Серый (TR!)
graze -- задевать, оцарапать, содрать (кожу)
grease -- жир, сало, мазь, смазка; смазывать (жиром)
greasy -- жирный, сальный
great -- великий
greater -- больше !NEW!
greatest -- самый большой (от great)
greatly -- очень
greedy -- жадный
greek -- Грек (TR!)
green -- зеленый
greenhouse -- Оранжерея (TR!)
greet -- приветствовать
greeted -- приветствовал (от greet)
greeting -- приветствие, поклон -ing
greetings -- приветствия (от greeting)
grew -- рос (от grow)
grey -- серый
gride -- Скрип (не creak) (TR!)
grief -- горе
grieved -- Огорченный (TR!)
grievously -- горестно
grill -- решетка
grim -- жестокий, свирепый, мрачный
grimly -- жестоко, решительно !NEW!
grin -- ухмыляться, усмешка
grind -- молоть, толочь, точить
grip -- схватывание
groan -- стон, стонать
grocer -- бакалейщик
gross -- большой (не large)
grotesque -- преувеличение
ground -- земля
grounds -- Основания(земля) (TR!)
group -- группа
grouping -- классификация g-ing
groups -- Группы (TR!)
grow -- расти
growing -- растущий
growl -- рычать, ворчать; рычание, ворчание g-
growled -- Рычал (TR!)
grown -- выращенный (от grow)
growth -- рост
grudge -- завидовать, жалеть (время, деньги)
grumble -- ворчать
grunt -- хрюкать, хрюканье
guarantee -- гарантия, гарантировать
guard -- охрана, стража
guarded -- Охраняемый (TR!)
guardian -- опекун, попечитель
guards -- Охраны (TR!)
guess -- отгадывать, догадка
guessing -- гадание
guest -- гость
guests -- гости (от guest)
guffaw -- хохот
guidance -- руководство
guide -- гид, экскурсовод
guided -- Управляемый(руководствуемый) (TR!)
guilt -- вина, виновность g-
guilty -- виноватый (g-)
guinea -- гинея (золотая монета, денежная единица; = 21 шиллингу)
gulf -- залив, бухта
gull -- чайка
gulped -- Проглоченный (TR!)
gum -- смола, клей; склеивать(ся) (не tar)
gums -- десны
gun -- ружье, пушка
gunpowder -- порох
gurgle -- бульканье (g-)
gus -- Гас (TR!)
gust -- порыв (ветра)
gutter -- водосточный желоб, канава
guy -- парень g- !NEW!
habit -- привычка
habits -- Привычки (TR!)
had -- вспомогательный глагол, имел (от have), не has
hail -- приветствовать
hair -- волосы
hairpin -- шпилька
hairs -- Волосы (TR!)
hairy -- волосатый
half -- половина
halfway -- на полпути !NEW!
hall -- зал
halt -- остановка, останавливать (не stop)
halted -- Приостановленный *a- (TR!)
ham -- ветчина
hammer -- молоток
hammock -- гамак
hamper -- препятствие
hand -- рука
handbag -- дамская сумочка
handbook -- справочник, руководство (не guidance)
handful -- горсть
handkerchief -- носовой платок
handle -- обращаться с, управлять (не manage)
handled -- Обработанный (TR!)
handling -- обращение -ing
hands -- руки (от hand)
handsome -- красивый
handy -- удобный; ловкий, искусный (h-)
hang -- повесить, висеть
hanging -- подвешивание
hanky -- носовой платок !NEW!
hannah -- Ханна (TR!)
hans -- Ханьшуй (TR!)
happen -- случаться, происходить
happened -- случился (от happen)
happening -- случай, событие
happily -- счастливо
happiness -- счастье
happy -- счастливый
harass -- беспокоить
harassment -- беспокойство
harbour -- гавань
hard -- с трудом, тяжело
harden -- твердеть
harder -- больше, упорнее (от hard)
hardly -- едва (не barely, merely)
hardship -- лишение
hardworking -- трудолюбивый
hare -- заяц
hari -- Хари (TR!)
harm -- беда, неприятность
harmless -- безвредный, безобидный
harmony -- гармония, согласованность
harness -- упряжь, запрягать
harold -- Гарольд (TR!)
harp -- арфа
harriet -- Гарриет (TR!)
harsh -- грубый, резкий (не sharp)
harshly -- грубо, резко
hart -- олень h-
harvest -- урожай
has -- имеет (от have)
haste -- спешка
hasten -- торопить(ся)
hastened -- поторопленный !NEW!
hastily -- поспешно, опрометчиво
hasty -- поспешный, необдуманный
hat -- шляпа
hatch -- высиживать
hatchet -- топор(ик)
hate -- ненавидеть
hated -- ненавидел (от hate)
hateful -- ненавистный
hatred -- ненависть
hats -- Шляпы (TR!)
haughty -- высокомерный, надменный
haul -- тянуть (не pull)
hauled -- Буксируемый (TR!)
haunt -- преследовать (о мыслях), появляться (как призрак)
haunted -- Часто посещаемый (TR!)
have -- иметь, вспомогательный глагол
haven -- гавань, убежище
having -- имеющий, обладающий (от have)
hay -- сено
hazard -- шанс, опасность h-
haze -- легкий туман (не mist)
he -- он
head -- голова, главный, руководить
headache -- головная боль
header -- Удар головой (TR!)
heading -- заголовок
headless -- Безголовый (TR!)
headlight -- фара (автомобиля), огни (паровоза)
headline -- заголовок
headlong -- очертя голову
headmaster -- Директор школы (TR!)
headphones -- наушники
headquarters -- штаб
heads -- головы (от head)
headstone -- Надгробный камень (TR!)
heal -- излечивать
health -- здоровье
healthy -- здоровый
heap -- куча
hear -- слышать
heard -- слушал, услышанный (от hear)
hearing -- слух
heart -- сердце
hearth -- печь, камин, домашний очаг
heartily -- сердечно
hearty -- искренний, (чисто)сердечный, радушный
heat -- жара
heating -- отопление
heaven -- небо, небеса, бог, провидение
heavily -- тяжело
heavy -- тяжелый
hedge -- ограда
hedgehog -- еж
hedwig -- Хедвиг (TR!)
heed -- внимание, слушать внимательно
heedless -- невнимательный, небрежный
heel -- пятка, каблук
heels -- пятки !NEW!
height -- высота
heir -- наследник
held -- держал !NEW!
helium -- Гелий (TR!)
hell -- черт
hello -- привет
helm -- руль
helmet -- шлем, каска
help -- помощь, помогать
helped -- помогал (от help)
helpful -- полезный h-
helping -- помощь
helpless -- беспомощный
hem -- рубец, кромка, кайма; подшивать, подрубать
hemp -- конопля, пенька
hen -- курица
hence -- следовательно
henceforward -- впредь, отныне
henrietta -- Генриетта (TR!)
her -- ее, ей
herd -- стадо
here -- здесь, вот
hereafter -- После этого(в будущем) (не afterward) (TR!)
hereditary -- наследственный
herein -- в этом, при сем
hermione -- Хермион (TR!)
hermit -- отшельник
hero -- герой
heroic -- героический
heroism -- героизм, доблесть
heron -- цапля
herring -- сельдь
hers -- ее
herself -- себя
hesitate -- колебаться
hesitation -- Колебание (TR!)
hey -- эй !NEW!
hi -- привет
hick -- провинциал, деревенщина !NEW!
hide -- прятать, спрятать
hideous -- безобразный, уродливый, страшный (не fearful)
high -- высокий (h-)
higher -- выше
highly -- очень, весьма
highness -- высота, возвышенность (не altitude)
highway -- большая дорога, шоссе
hike -- путешествовать пешком
hiking -- пеший поход
hill -- холм, гора
hills -- Холмы (TR!)
hillside -- Склон (TR!)
him -- его, ему
himself -- себя, себе, сам
hinder -- препятствовать, мешать
hinge -- петля, шарнир; висеть, вращаться на петлях
hint -- намек, намекать
hip -- ягода шиповника
hire -- взять напрокат
his -- его (-s)
hiss -- свистеть, шипеть, свист
hissed -- шипящий (-ed) !NEW!
hist -- тише!, тс! (TR!)
historic -- исторический
historical -- исторический
history -- история
hit -- успех, удача, попадать в цель
hitherto -- до сих пор
hive -- улей
hoard -- запас; запасать, копить (не spare, stock)
hoarse -- хриплый
hoax -- разыгрывать
hobble -- хромота, прихрамывать, ковылять
hobby -- хобби
hockey -- хоккей
hoe -- мотыга, рыхлить землю
hog -- свинья, боров
hoist -- поднимать (флаг, парус)
hold -- держать(ся), выдерживать, захват, владение
holder -- владелец, ручка, рукоятка
holding -- удерживание, держащий (от hold)
holds -- Держится (TR!)
hole -- отверстие, яма
holes -- Отверстия (TR!)
holiday -- отпуск, праздник
holidays -- каникулы (не vacation)
hollow -- пустой
hols -- каникулы, отпуск !NEW!
holy -- священный, святой
home -- дом
homes -- дома (от home)
homework -- домашнее задание
honest -- честный
honestly -- честно !NEW!
honey -- мед
honeycomb -- соты
honor -- Честь (TR!)
honorable -- Благородный (TR!)
honorary -- почетный
honour -- честь
honourable -- почетный, почтенный, честный
honoured -- Чтимый(удостоенный) (TR!)
hood -- капюшон, капор, колпак, крышка (тех.)
hoof -- копыто
hook -- крючок
hooker -- Проститутка (TR!)
hookup -- Соединение (TR!)
hoop -- обруч
hooter -- Гудок (не buzzer) (TR!)
hop -- хмель (бот.)
hope -- надеяться
hoped -- надеялся (от hope)
hopeful -- надеющийся, подающий надежды, многообещающий
hopefully -- с надеждой !NEW!
hopeless -- безнадежный
hopes -- Надежды (TR!)
hopped -- Прыгал (не sprang, leaped, jumped) (TR!)
hopper -- Бункер (TR!)
horace -- Хорас (TR!)
horizon -- горизонт
horizontal -- горизонтальный
horizontally -- Горизонтально (TR!)
horn -- рог, забодать
horns -- Рожки (TR!)
horrible -- ужасный h-
horrid -- ужасный *o- !NEW!
horror -- ужас h
horse -- лошадь
horseman -- наездник
hose -- чулки
hospital -- больница
hospitality -- гостеприимство
host -- хозяин
hostess -- хозяйка
hostile -- враждебный (не adverse)
hostility -- враждебность (не adversity)
hot -- горячий
hotel -- гостиница
hotter -- жарче (от hot)
hour -- час
hours -- часы (от hour)
house -- дом
household -- домашнее хозяйство
housekeeper -- экономка
housewife -- домашняя хозяйка
housework -- работа по дому
hover -- парить, вертеться
how -- как
however -- однако
howl -- выть, вой (не wail)
hrs -- Часы (TR!)
hug -- крепко обнимать
huge -- огромный (не bulk)
hugo -- Хьюго (TR!)
hum -- жужжать, гудеть
human -- человеческий
humanity -- человечество
humble -- скромный h-
humbug -- обманщик, ханжа
humor -- юмор
humorous -- смешной
humour -- юмор, настроение
hump -- горб
hunchback -- горбун
hundred -- сто
hundreds -- Сотни (TR!)
hundredth -- сотый
hung -- вешал, был склонным !NEW!
hunger -- голод (h-)
hungry -- голодный (не от слова starve)
hunt -- охотиться
hunter -- охотник
hunting -- охота
hurricane -- ураган h-
hurried -- спешил, торопился (от hurry)
hurriedly -- поспешно !NEW!
hurry -- спешить, торопиться, спешка
hurt -- рана, болеть, причинить боль, повредить
hurts -- болеет, причиняет боль, повреждает (от hurt)
husband -- муж
hush -- водворять тишину
hut -- хижина
hybrid -- Гибрид (TR!)
hybrids -- Гибриды (TR!)
hygienic -- гигиенический
hypothesis -- Гипотеза (TR!)
hysteria -- истерия
hysterical -- истерический
I -- я
ice -- лед
icebox -- холодильник (морозильник) (не fridge)
icicle -- сосулька
icy -- ледяной
idea -- идея, мысль
ideal -- идеал, идеальный
identical -- тождественный
identification -- отождествление
identifier -- Идентификатор (TR!)
identifiers -- Идентификаторы (TR!)
identify -- опознавать, распознавать; устанавливать личность
idiot -- идиот
idle -- бесполезный
if -- если
ignition -- зажигание, воспламенение
ignorance -- незнание, невежество
ignorant -- невежественный, неосведомленный, несведущий
ignore -- игнорировать
ill -- больной
illegal -- нелегальный
illiterate -- неграмотный
illness -- болезнь
illuminate -- освещать
illuminated -- Освещенный (TR!)
illumination -- освещение
illusion -- иллюзия
illustration -- Иллюстрация (TR!)
image -- изображение, образ, имидж
imagination -- воображение
imagine -- думать, воображать
imitate -- подражать
imitation -- подражание, имитация
immediate -- непосредственный
immediately -- немедленно
immense -- громадный, необъятный
immensely -- чрезвычайно i-
immersed -- Погруженный (TR!)
imminent -- надвигающийся
immortal -- бессмертный
impact -- удар (не stroke)
impatience -- нетерпение
impatient -- нетерпеливый
impatiently -- нетерпеливо
impediment -- препятствие
impenetrable -- непроницаемый
imperative -- повелительное наклонение (грам.)
imperfect -- несовершенный
imperial -- Имперский (TR!)
impertinence -- дерзость
implement -- выполнять
implementation -- Выполнение (TR!)
implemented -- Осуществленный (TR!)
implied -- подразумеваемый (i-)
impolite -- невежливый, неучтивый
import -- импорт, ввоз
importance -- важность
important -- важный
impose -- налагать
impossible -- невозможный
impostor -- самозванец, плут
impress -- производить впечатление
impression -- впечатление
impressive -- впечатляющий -ve
imprison -- заключать в тюрьму
improbable -- невероятный
improve -- улучшать
improved -- улучшил (от improve)
improvement -- улучшение
improvements -- Усовершенствования (TR!)
impulse -- побуждение, порыв
impure -- нечистый, грязный, с примесью
in -- в
inability -- неспособность
inaccessible -- недоступный
incessant -- непрерывный, вечный
inch -- дюйм
inches -- Дюймы (TR!)
incident -- инцидент
incidentally -- между прочим
inclination -- склонность
incline -- склонять
inclined -- наклонный
include -- включать
included -- включенный (от include)
including -- включая
inclusion -- включение
income -- доход, заработок
incomprehensible -- непонятный, непостижимый i-
inconsistent -- непоследовательный
inconvenient -- неудобный
incorrect -- неверный, неправильный
increase -- рост
increasing -- возрастающий
increasingly -- все больше и больше
incredible -- невероятно
incur -- подвергаться
indebted -- обязанный
indeed -- неужели, действительно (не really)
indefinite -- неопределенный, неограниченный
independence -- независимость
independent -- независимый
independently -- независимо
index -- индекс, указатель, показатель
indexes -- Индексы (TR!)
indians -- Индусы(индейцы) (TR!)
indicate -- показывать, указывать
indices -- Индексы (не indexes) (TR!)
indifference -- безразличие
indifferent -- безразличный
indigenous -- местный
indigestion -- несварение, расстройство
indignant -- негодующий, возмущенный
indignation -- негодование, возмущение
indirect -- косвенный
individual -- личность, индивидуальный
indolent -- ленивый, праздный, безболезненный
indoors -- в помещении
induce -- убеждать
induced -- Вынужденный(вызванный) (TR!)
industrial -- промышленный
industrious -- трудолюбивый, прилежный (не hardworking)
industry -- промышленность
ineffective -- неэффективный
inevitable -- неизбежный
infant -- младенец
infer -- заключать, делать вывод
inferior -- худший, плохой
infinite -- безграничный, бесконечный
infinitely -- бесконечно
inflected -- Склоняемый (TR!)
inflection -- Сгибание (TR!)
inflict -- наносить удар
influence -- влияние, влиять
influenced -- влиял (от influence)
info -- Информация (TR!)
inform -- сообщать
information -- информация
informed -- осведомленный
informs -- Сообщает (TR!)
inga -- Инга (TR!)
ingenious -- изобретательный, остроумный, находчивый
ingratitude -- неблагодарность
ingredient -- составная часть
inhabit -- жить, обитать
inhabitant -- житель
inhabitants -- Жители (TR!)
inhabited -- Населенный *n- (TR!)
inhale -- вдыхать
inherent -- неотъемлемый, присущий, свойственный (не Integral)
inherit -- (у)наследовать
inheritance -- наследство
inherited -- Унаследованный (TR!)
initial -- начальный, первоначальный
initially -- вначале i-
initiate -- начинать (не commence)
inject -- впрыскивать
injunction -- предписание
injure -- ушибиться -e
injured -- поврежденный i-
injury -- телесное повреждение
injustice -- несправедливость
ink -- чернила
inland -- внутренний
inn -- гостиница, постоялый двор
inner -- внутренний
innocence -- невинность, невиновность
innocent -- наивный, невинный
innumerable -- бесчисленный
input -- Вход (TR!)
inquire -- спрашивать, узнавать
inquired -- осведомлённый (не informed) !NEW!
inquiries -- справочное (от inquiry)
inquiry -- расспросы, наведение справок
inquisitive -- любопытный
insane -- душевнобольной, ненормальный
inscription -- надпись
insect -- насекомое
insects -- Насекомые (TR!)
insecure -- ненадежный, небезопасный (insecure)
insert -- вставлять, помещать (в газете)
inside -- внутрь, внутри
insignificant -- незначительный, ничтожный
insist -- настаивать
insolent -- наглый, дерзкий, оскорбительный
inspect -- осматривать, инспектировать
inspection -- осмотр
inspector -- контролер, инспектор i-
inspiration -- вдохновение
inspired -- Вдохновленный (TR!)
install -- водворять, устраивать, устанавливать
installation -- Установка (TR!)
installed -- Установленный (TR!)
installer -- Монтажник (TR!)
installing -- Монтаж -ing (TR!)
installs -- Устанавливает (TR!)
instance -- пример
instances -- Случаи *n- (TR!)
instant -- мгновение
instantly -- немедленно
instead -- вместо, взамен
instinct -- инстинкт
instinctive -- инстинктивный
institution -- учреждение
instruct -- инструктировать
instruction -- инструкция
instructor -- инструктор
instrument -- инструмент
insufficient -- недостаточный
insult -- оскорбление
insurance -- страхование, страховка
intake -- поглощение
integer -- Целое число (TR!)
integral -- неотъемлемый
intellectual -- интеллигент
intelligence -- интеллект
intelligent -- умный
intend -- намереваться
intended -- предполагаемый i-
intense -- интенсивный, напряженный
intent -- намерение, цель i-
intention -- намерение, замысел
intentional -- умышленный
intentions -- Намерения (TR!)
intently -- внимательно !NEW!
interbase -- Межоснова (TR!)
intercept -- перехватывать
intercourse -- общение
interdependent -- взаимозависимый
interest -- интересовать, заинтересовывать
interested -- заинтересованный, интересующийся (от interest)
interesting -- интересный
interface -- Интерфейс (TR!)
interfere -- мешать
interference -- вмешательство
interfering -- Вмешательство -ing (TR!)
interior -- внутренний (не internal)
intermediate -- Промежуточное звено (TR!)
internal -- внутренний
international -- международный
interposed -- Вставленный (TR!)
interpret -- интерпретировать, переводить(устно) i-
interrupt -- прерывать, мешать
interruption -- прерывание
interval -- антракт, промежуток
intervals -- Интервалы (TR!)
intervention -- посредничество
interview -- встреча, беседа
intimate -- глубокий, интимный
intimidate -- пугать, запугивать
into -- в
intolerable -- невыносимый, нестерпимый
intricate -- запутанный (не entangled)
intrigue -- интрига
introduce -- предстaвлять, знакомить
introduction -- введение
intrude -- вторгаться, вмешиваться, навязываться
invade -- вторгаться
invader -- захватчик
invalid -- недействительный (не Illegal)
invaluable -- неоценимый
invariably -- неизменно
invent -- изобретать, изобрести
invention -- выдумка, изобретательность
inventor -- изобретатель
inventory -- опись
invest -- вкладывать, помещать (капитал)
investigate -- исследовать
investigation -- исследование
investigator -- исследователь
invisible -- невидимый
invitation -- приглашение
invitations -- приглашения (от invitation)
invite -- приглашать
invited -- пригласил, приглашенный (от invite)
involuntary -- невольный
involve -- втягивать, вовлекать
involved -- сложный
inward -- внутрь
irene -- Ирэн (TR!)
iron -- железо, утюг
ironic -- иронический
ironical -- иронический
irregular -- неправильный
irresistible -- непреодолимый
irresolute -- нерешительный
irresponsibility -- безответственность
irritation -- раздражение
is -- есть (от be)
isabella -- Изабелла (TR!)
island -- остров
isle -- остров(ок)
iso -- Международная организация по стандартизации (TR!)
isobel -- Исобел (TR!)
isolation -- изоляция
issue -- выпуск, издание, выпускать
issued -- Выпущенный (TR!)
issues -- Проблемы(выпуски) (TR!)
it -- это, он, она (для предметов и животных)
italian -- Итальянец (TR!)
italy -- Италия (TR!)
item -- вещь, предмет
its -- его, ее (от it)
itself -- себя, себе
ivan -- Иван (TR!)
ivory -- слоновая кость
ivy -- плющ
jack -- домкрат
jackal -- шакал
jacket -- куртка
jackson -- Джэксон (TR!)
jail -- тюрьма
jake -- Джейк (TR!)
jam -- варенье, джем
james -- Джеймс (TR!)
jan -- Январь (TR!)
January -- январь
jar -- ссора
jaw -- челюсть
jaws -- Челюсти (TR!)
jazz -- джаз
jealous -- ревнивый
jealousy -- ревность
jean -- Хлопчатобумажная ткань (TR!)
jeanne -- Джин (TR!)
jeans -- джинсы
jeer -- насмешка *e-
jeff -- Джеф (TR!)
jelly -- желе
jenny -- Дженни (TR!)
jerk -- резкий толчок, подергивание; резко толкать, дергать
jersey -- джемпер (-.....s....-)
jerusalem -- Иерусалим (TR!)
jessamy -- Джессами (TR!)
jessie -- Джесси (TR!)
jest -- шутка; шутить, высмеивать (не joke)
jet -- струя (воды, пара, газа)
jew -- Еврей (TR!)
jewel -- драгоценность
jeweller -- ювелир
jewellery -- ювелирные изделия
jewels -- драгоценности
jill -- Джилл (TR!)
jim -- Джим (TR!)
jo -- Джо (TR!)
joan -- Джоан (TR!)
job -- работа
jobs -- работы (от job)
joe -- кофе !NEW!
join -- соединяться
joining -- соединение
joint -- совместный, объединенный (j-)
joke -- шутка, шутить
joking -- шутка, шутящий (от joke)
jolly -- очень, веселый
jonas -- Джонас (TR!)
joseph -- Джозеф (TR!)
josephine -- Джозефина (TR!)
josie -- Джоси (TR!)
journal -- журнал j-
journey -- путешествие
joy -- радость
joyful -- радостный, довольный
joyfully -- Радостно *o- (TR!)
judge -- судья
judged -- Оцененный *u- (не valued) (TR!)
judgement -- приговор, суждение
judgment -- Суждение (TR!)
jug -- кувшин
juice -- сок
juicy -- сочный, дождливый
July -- июль
jumble -- толкаться
jump -- прыгать
jumped -- прыгал(а) (от jump)
jumper -- джемпер
June -- июнь
jungle -- джунгли
junior -- младший
junk -- рухлядь !NEW!
jury -- присяжные, жюри